able - способный
achievement - достижение
apply for - устраиваться
associate - ассоциат
bachelor - бакалавр
change - менять
create - создавать
degree - степень
elementary - базовый
experience - опыт
familiar - знакомый
fluent - беглый
full-time - полная ставка
great - огромный
highly - высоко
implement - внедрить
improve - улучшить
intermediate - средний
layout - формат
operate - работать
opportunity - возможность
part-time - неполная ставка
prioritize - расставлять приоритеты
range - ряд
reduce - снижать
relevant - соответствующий
reverse - обратный
skills - навыки
upper-intermediate - выше среднего
update - обновлять